/v1/acl/info	GET
/v1/acl/list	GET
/v1/acl/replication	GET
/v1/agent/check/deregister	PUT
/v1/agent/check/fail	PUT
/v1/agent/check/pass	PUT
/v1/agent/check/register	PUT
/v1/agent/check/warn	PUT
/v1/agent/checks	GET
/v1/agent/force-leave	PUT
/v1/agent/join	PUT
/v1/agent/members	GET
/v1/agent/metrics	GET
/v1/agent/self	GET
/v1/agent/service/register	PUT
/v1/agent/service/deregister	PUT
/v1/agent/services	GET
/v1/catalog/datacenters	GET
/v1/catalog/deregister	PUT
/v1/catalog/node	GET
/v1/catalog/nodes	GET
/v1/catalog/register	PUT
/v1/catalog/service	GET
/v1/catalog/services	GET
/v1/coordinate/datacenters	GET
/v1/coordinate/nodes	GET
/v1/health/checks	GET
/v1/health/node	GET
/v1/health/service	GET
/v1/health/state	GET
/v1/internal/ui/node	GET
/v1/internal/ui/nodes	GET
/v1/internal/ui/services	GET
/v1/session/info	GET
/v1/session/list	GET
/v1/session/node	GET
/v1/status/leader	GET
/v1/status/peers	GET
/v1/operator/area/:uuid/members	GET
/v1/operator/area/:uuid/join	PUT